0 0 0 0 0 0 0 0 0 0 0 0 0 0 0 0 0 0 0 0 0 0 0 0 0 0 0 0 0 22 22 22 22 22 22 22 22 22 22 22 22 22 22 22 22 22 22 22 22 22 22 22 22 22 22 22 22 22 22 22 22 22 22 22 22 22 22 22 22 22 22 22 0 0 0 0 0 0 0 0 0 0 0 0 0 0 0 0 0 0 0 0 0 0 0 0 0 0 0 0 
0 0 0 0 0 0 0 0 0 0 0 0 0 0 0 0 0 0 0 0 0 0 0 0 0 0 0 0 0 22 23 23 23 23 23 23 23 23 23 23 23 23 23 23 23 23 23 23 23 23 23 23 23 23 23 23 23 23 23 23 23 23 23 23 23 23 23 23 23 23 23 22 0 0 0 0 0 0 0 0 0 0 0 0 0 0 0 0 0 0 0 0 0 0 0 0 0 0 0 0 
0 0 0 0 0 0 0 0 0 0 0 0 0 0 0 0 0 0 0 0 0 0 0 0 0 0 0 0 0 22 21 21 21 21 21 21 21 21 21 21 21 21 21 21 21 21 21 21 21 21 21 21 21 21 21 21 21 21 21 21 21 21 21 21 21 21 21 21 21 21 21 22 0 0 0 0 0 0 0 0 0 0 0 0 0 0 0 0 0 0 0 0 0 0 0 0 0 0 0 0 
0 0 0 0 0 0 0 0 0 0 0 0 0 0 0 0 0 0 0 0 0 0 0 0 0 0 0 0 0 22 21 21 21 21 21 21 21 21 21 21 21 21 21 21 21 21 21 21 21 21 21 21 21 21 21 21 21 21 21 21 21 21 21 21 21 21 21 21 21 21 21 22 0 0 0 0 0 0 0 0 0 0 0 0 0 0 0 0 0 0 0 0 0 0 0 0 0 0 0 0 
0 0 0 0 0 0 0 0 0 0 0 0 0 0 0 0 0 0 0 0 0 0 0 0 0 0 0 0 0 22 21 21 21 21 21 21 21 21 21 21 21 21 21 21 21 21 21 21 21 21 21 21 21 21 21 21 21 21 21 21 21 21 21 21 21 21 21 21 21 21 25 22 0 0 0 0 0 0 0 0 0 0 0 0 0 0 0 0 0 0 0 0 0 0 0 0 0 0 0 0 
0 0 0 0 0 0 0 0 0 0 0 0 0 0 0 0 0 0 0 0 0 0 0 0 0 0 0 0 0 22 21 21 21 21 21 21 21 21 21 21 21 21 21 21 21 21 21 21 21 21 21 21 21 21 21 21 21 21 21 21 21 21 21 21 21 21 21 21 21 25 25 22 0 0 0 0 0 0 0 0 0 0 0 0 0 0 0 0 0 0 0 0 0 0 0 0 0 0 0 0 
0 0 0 0 0 0 0 0 0 0 0 0 0 0 0 0 0 0 0 0 0 0 0 0 0 0 0 0 0 22 24 24 21 21 21 21 21 21 21 21 21 21 21 21 21 21 21 21 21 21 21 21 21 21 21 21 21 21 21 21 21 21 21 21 21 21 21 21 25 25 25 22 0 0 0 0 0 0 0 0 0 0 0 0 0 0 0 0 0 0 0 0 0 0 0 0 0 0 0 0 
0 0 0 0 0 0 0 0 0 0 0 0 0 0 0 0 0 0 0 0 0 0 0 0 0 0 0 0 0 22 25 25 21 21 21 21 21 21 21 21 21 21 21 21 21 21 21 21 21 21 21 21 21 21 21 21 21 21 21 21 21 21 21 21 21 21 25 25 25 25 25 22 0 0 0 0 0 0 0 0 0 0 0 0 0 0 0 0 0 0 0 0 0 0 0 0 0 0 0 0 
0 0 0 0 0 0 0 0 0 0 0 0 0 0 0 0 0 0 0 0 0 0 0 0 0 0 0 0 0 22 25 25 25 25 21 21 21 21 21 21 21 21 21 21 21 21 21 21 21 21 21 21 21 21 21 21 21 21 21 21 21 21 21 25 25 25 25 25 25 25 25 22 0 0 0 0 0 0 0 0 0 0 0 0 0 0 0 0 0 0 0 0 0 0 0 0 0 0 0 0 
0 0 0 0 0 0 0 0 0 0 0 0 0 0 0 0 0 0 0 0 0 0 0 0 0 0 0 0 0 22 25 25 25 25 21 21 21 21 21 21 21 21 21 21 21 21 21 21 21 21 21 21 21 21 21 21 21 21 21 21 21 21 25 25 25 25 25 25 25 25 25 22 0 0 0 0 0 0 0 0 0 0 0 0 0 0 0 0 0 0 0 0 0 0 0 0 0 0 0 0 
0 0 0 0 0 0 0 0 0 0 0 0 0 0 0 0 0 0 0 0 0 0 0 0 0 0 0 0 0 22 25 25 25 25 25 21 21 21 21 21 21 21 21 21 21 21 21 21 21 21 21 21 21 21 21 21 21 21 21 21 25 25 25 25 25 25 25 25 25 25 25 22 0 0 0 0 0 0 0 0 0 0 0 0 0 0 0 0 0 0 0 0 0 0 0 0 0 0 0 0 
0 0 0 0 0 0 0 0 0 0 0 0 0 0 0 0 0 0 0 0 0 0 0 0 0 0 0 0 0 22 22 22 22 22 22 22 22 22 22 22 22 22 22 22 22 22 22 22 22 22 21 22 22 22 22 22 22 22 22 22 22 22 22 22 22 22 22 22 22 22 22 22 0 0 0 0 0 0 0 0 0 0 0 0 0 0 0 0 0 0 0 0 0 0 0 0 0 0 0 0 
0 0 0 0 0 0 0 0 0 0 0 0 0 0 0 0 0 0 0 0 0 0 0 0 0 0 0 0 0 0 0 0 0 0 0 0 0 0 0 0 0 0 0 0 0 0 0 0 0 22 21 22 0 0 0 0 0 0 0 0 0 0 0 0 0 0 0 0 0 0 0 0 0 0 0 0 0 0 0 0 0 0 0 0 0 0 0 0 0 0 0 0 0 0 0 0 0 0 0 0 
0 0 0 0 0 0 0 0 0 0 0 0 0 0 0 0 0 0 0 0 0 0 0 0 0 0 0 0 0 0 0 0 0 0 0 0 0 0 0 0 0 0 0 0 0 0 0 0 0 22 21 22 0 0 0 0 0 0 0 0 0 0 0 0 0 0 0 0 0 0 0 0 0 0 0 0 0 0 0 0 0 0 0 0 0 0 0 0 0 0 0 0 0 0 0 0 0 0 0 0 
0 0 0 0 0 0 0 0 0 0 0 0 0 0 0 0 0 0 0 0 0 0 0 0 0 0 0 0 0 0 0 0 0 0 0 0 0 0 0 0 0 0 0 0 0 0 0 0 0 22 21 22 0 0 0 0 0 0 0 0 0 0 0 0 0 0 0 0 0 0 0 0 0 0 0 0 0 0 0 0 0 0 0 0 0 0 0 0 0 0 0 0 0 0 0 0 0 0 0 0 
0 0 0 0 0 0 0 0 0 0 0 0 0 0 0 0 0 0 0 0 0 0 0 0 0 0 0 0 0 0 0 0 0 0 0 0 0 0 0 0 0 0 0 0 0 0 0 0 0 22 26 22 0 0 0 0 0 0 0 0 0 0 0 0 0 0 0 0 0 0 0 0 0 0 0 0 0 0 0 0 0 0 0 0 0 0 0 0 0 0 0 0 0 0 0 0 0 0 0 0 
0 0 0 0 0 0 0 0 0 0 0 0 0 0 0 0 0 0 0 0 0 0 0 0 0 0 0 0 0 0 0 0 0 0 0 0 0 0 0 0 0 0 0 0 0 0 0 0 0 22 21 22 0 0 0 0 0 0 0 0 0 0 0 0 0 0 0 0 0 0 0 0 0 0 0 0 0 0 0 0 0 0 0 0 0 0 0 0 0 0 0 0 0 0 0 0 0 0 0 0 
0 0 0 0 0 0 0 0 0 0 0 0 0 0 0 0 0 0 0 0 0 0 0 0 0 0 0 0 0 0 0 0 0 0 0 0 0 0 0 0 0 0 0 0 0 0 0 0 0 22 21 22 0 0 0 0 0 0 0 0 0 0 0 0 0 0 0 0 0 0 0 0 0 0 0 0 0 0 0 0 0 0 0 0 0 0 0 0 0 0 0 0 0 0 0 0 0 0 0 0 
0 0 0 0 0 0 0 0 0 0 0 0 0 22 22 22 22 22 22 22 22 22 22 22 0 0 0 0 0 22 22 22 22 22 22 22 22 22 22 22 0 0 0 0 0 22 22 22 22 22 21 22 22 22 22 22 0 0 0 0 0 22 22 22 22 22 22 22 22 22 22 22 0 0 0 0 0 0 22 22 22 22 22 22 22 22 22 22 22 0 0 0 0 0 0 0 0 0 0 0 
0 0 0 0 0 0 0 0 0 0 0 0 0 22 21 23 23 21 21 21 23 23 24 22 0 0 0 0 0 22 21 23 23 21 21 21 21 23 23 22 0 0 0 0 0 22 21 23 23 21 21 21 23 23 21 22 0 0 0 0 0 22 21 21 21 21 21 23 21 23 21 22 0 0 0 0 0 0 22 25 21 21 21 21 21 21 23 23 22 0 0 0 0 0 0 0 0 0 0 0 
0 0 0 0 0 0 0 0 0 0 0 0 0 22 21 21 21 21 21 21 21 21 21 22 0 0 0 0 0 22 21 21 21 21 21 21 21 21 25 22 0 0 0 0 0 22 21 21 21 21 21 21 21 21 21 22 0 0 0 0 0 22 25 25 21 21 21 21 21 21 21 22 0 0 0 0 0 0 22 25 21 21 21 21 21 21 21 24 22 0 0 0 0 0 0 0 0 0 0 0 
0 0 0 0 0 0 0 0 0 0 0 0 0 22 21 21 21 21 21 21 21 21 21 22 0 0 0 0 0 22 21 21 21 21 21 21 21 21 25 22 0 0 0 0 0 22 21 21 21 21 21 21 21 21 21 22 0 0 0 0 0 22 21 21 21 21 21 21 21 21 21 22 0 0 0 0 0 0 22 21 21 21 21 20 21 21 21 21 22 0 0 0 0 0 0 0 0 0 0 0 
0 0 0 0 0 0 0 0 0 0 0 0 0 22 21 21 21 21 21 21 21 21 21 22 22 22 22 22 22 22 21 21 21 21 20 21 21 21 21 22 22 22 22 22 22 22 21 21 21 21 21 21 21 21 21 22 22 22 22 22 22 22 21 21 21 20 20 20 21 21 21 22 22 22 22 22 22 22 22 21 21 21 21 20 20 21 21 21 22 0 0 0 0 0 0 0 0 0 0 0 
0 0 0 0 0 0 0 0 0 0 0 0 0 22 21 21 21 21 21 21 21 21 21 21 21 21 21 21 21 21 21 21 21 20 20 20 20 21 21 21 21 21 21 21 21 21 21 21 21 20 20 20 21 21 21 21 21 21 21 21 21 21 21 21 20 20 20 21 21 21 21 21 21 21 21 21 21 21 21 21 21 21 21 21 20 20 21 21 22 0 0 0 0 0 0 0 0 0 0 0 
0 0 0 0 0 0 0 0 0 0 0 0 0 22 21 21 21 21 21 21 21 21 21 22 22 22 22 22 22 22 21 21 21 20 20 20 21 21 25 22 22 22 22 22 22 22 21 20 20 20 20 20 21 21 21 22 22 22 22 22 22 22 21 21 21 21 21 21 21 21 21 22 22 22 22 22 22 22 22 21 21 21 21 21 21 20 21 25 22 0 0 0 0 0 0 0 0 0 0 0 
0 0 0 0 0 0 0 0 0 0 0 0 0 22 21 21 21 21 21 21 21 21 21 22 0 0 0 0 0 22 21 21 21 20 20 21 21 25 25 22 0 0 0 0 0 22 21 20 21 20 20 21 21 21 21 22 0 0 0 0 0 22 21 21 21 21 21 21 21 21 21 22 0 0 0 0 0 0 22 21 21 21 21 21 21 21 21 25 22 0 0 0 0 0 0 0 0 0 0 0 
0 0 0 0 0 0 0 0 0 0 0 0 0 22 25 25 21 21 21 21 21 21 21 22 0 0 0 0 0 22 25 21 21 21 21 21 21 21 21 22 0 0 0 0 0 22 21 21 21 21 21 21 21 25 25 22 0 0 0 0 0 22 25 21 21 21 21 21 21 21 21 22 0 0 0 0 0 0 22 21 21 21 21 21 21 21 25 25 22 0 0 0 0 0 0 0 0 0 0 0 
0 0 0 0 0 0 0 0 0 0 0 0 0 22 25 25 21 21 21 21 21 21 21 22 0 0 0 0 0 22 25 25 21 21 21 21 25 25 24 22 0 0 0 0 0 22 21 24 21 21 21 21 25 25 25 22 0 0 0 0 0 22 25 25 25 21 21 21 21 24 21 22 0 0 0 0 0 0 22 21 21 21 21 21 21 21 25 25 22 0 0 0 0 0 0 0 0 0 0 0 
0 0 0 0 0 0 0 0 0 0 0 0 0 22 22 22 22 22 21 22 22 22 22 22 0 0 0 0 0 22 22 22 22 22 21 22 22 22 22 22 0 0 0 0 0 22 22 22 22 22 21 22 22 22 22 22 0 0 0 0 0 22 22 22 22 22 21 22 22 22 22 22 0 0 0 0 0 0 22 22 22 22 22 21 22 22 22 22 22 0 0 0 0 0 0 0 0 0 0 0 
0 0 0 0 0 0 0 0 0 0 0 0 0 0 0 0 0 22 21 22 0 0 0 0 0 0 0 0 0 0 0 0 0 22 21 22 0 0 0 0 0 0 0 0 0 0 0 0 0 22 21 22 0 0 0 0 0 0 0 0 0 0 0 0 0 22 21 22 0 0 0 0 0 0 0 0 0 0 0 0 0 0 22 21 22 0 0 0 0 0 0 0 0 0 0 0 0 0 0 0 
0 0 0 0 0 0 0 0 0 0 0 0 0 0 0 0 0 22 21 22 0 0 0 0 0 0 0 0 0 0 0 0 0 22 21 22 0 0 0 0 0 0 0 0 0 0 0 0 0 22 21 22 0 0 0 0 0 0 0 0 0 0 0 0 0 22 21 22 0 0 0 0 0 0 0 0 0 0 0 0 0 0 22 21 22 0 0 0 0 0 0 0 0 0 0 0 0 0 0 0 
0 0 0 0 0 0 0 0 0 0 0 0 0 0 0 0 0 22 26 22 0 0 0 0 0 0 0 0 0 0 0 0 0 22 26 22 0 0 0 0 0 0 0 0 0 0 0 0 0 22 26 22 0 0 0 0 0 0 0 0 0 0 0 0 0 22 26 22 0 0 0 0 0 0 0 0 0 0 0 0 0 0 22 26 22 0 0 0 0 0 0 0 0 0 0 0 0 0 0 0 
0 0 0 0 0 0 0 0 0 0 0 0 0 0 0 0 0 22 21 22 0 0 0 0 0 0 0 0 0 0 0 0 0 22 21 22 0 0 0 0 0 0 0 0 0 0 0 0 0 22 21 22 0 0 0 0 0 0 0 0 0 0 0 0 0 22 21 22 0 0 0 0 0 0 0 0 0 0 0 0 0 0 22 21 22 0 0 0 0 0 0 0 0 0 0 0 0 0 0 0 
0 0 0 0 0 0 0 0 0 0 0 0 0 0 0 0 0 22 21 22 0 0 0 0 0 0 0 0 0 0 0 0 0 22 21 22 0 0 0 0 0 0 0 0 0 0 0 0 0 22 21 22 0 0 0 0 0 0 0 0 0 0 0 0 0 22 21 22 0 0 0 0 0 0 0 0 0 0 0 0 0 0 22 21 22 0 0 0 0 0 0 0 0 0 0 0 0 0 0 0 
0 0 0 0 0 0 0 0 0 0 0 0 0 22 22 22 22 22 21 22 22 22 22 22 0 0 0 0 0 22 22 22 22 22 21 22 22 22 22 22 0 0 0 0 0 22 22 22 22 22 21 22 22 22 22 22 0 0 0 0 0 22 22 22 22 22 21 22 22 22 22 22 0 0 0 0 0 0 22 22 22 22 22 21 22 22 22 22 22 0 0 0 0 0 0 0 0 0 0 0 
0 0 0 0 0 0 0 0 0 0 0 0 0 22 21 23 21 21 21 21 23 23 21 22 0 0 0 0 0 22 21 23 23 23 21 21 21 23 21 22 0 0 0 0 0 22 23 23 21 21 21 21 21 23 23 22 0 0 0 0 0 22 23 21 21 21 21 21 23 23 23 22 0 0 0 0 0 0 22 23 23 21 21 21 21 21 23 21 22 0 0 0 0 0 0 0 0 0 0 0 
0 0 0 0 0 0 0 0 0 0 0 0 0 22 21 21 21 21 21 21 21 21 21 22 0 0 0 0 0 22 21 21 21 21 21 21 21 21 21 22 0 0 0 0 0 22 21 21 21 21 21 21 21 25 25 22 0 0 0 0 0 22 21 21 21 21 21 21 21 21 21 22 0 0 0 0 0 0 22 21 21 21 21 21 21 21 21 21 22 0 0 0 0 0 0 0 0 0 0 0 
0 0 0 0 0 0 0 0 0 0 0 0 0 22 21 21 21 21 21 21 21 21 21 22 0 0 0 0 0 22 21 21 21 21 20 21 21 21 21 22 0 0 0 0 0 22 21 21 21 21 21 21 21 25 25 22 0 0 0 0 0 22 21 21 21 21 21 21 21 21 21 22 0 0 0 0 0 0 22 25 25 21 21 21 21 21 21 21 22 0 0 0 0 0 0 0 0 0 0 0 
0 0 0 0 0 0 0 0 0 0 0 0 0 22 21 21 21 21 21 21 21 21 21 22 22 22 22 22 22 22 21 21 21 20 20 21 21 21 21 22 22 22 22 22 22 22 21 21 21 21 21 21 21 21 21 22 22 22 22 22 22 22 21 21 21 21 21 21 21 21 21 22 22 22 22 22 22 22 22 25 25 21 21 21 21 21 21 21 22 0 0 0 0 0 0 0 0 0 0 0 
0 0 0 0 0 0 0 0 0 0 0 0 0 22 21 21 21 21 21 21 21 21 21 21 21 21 21 21 21 21 21 21 20 20 21 21 21 21 21 21 21 21 21 21 21 21 21 21 20 20 20 20 21 21 21 21 21 21 21 21 21 21 21 21 21 21 21 20 21 21 21 21 21 21 21 21 21 21 21 21 21 21 21 21 20 20 21 21 22 0 0 0 0 0 0 0 0 0 0 0 
0 0 0 0 0 0 0 0 0 0 0 0 0 22 21 21 21 21 21 21 21 21 21 22 22 22 22 22 22 22 21 21 21 21 21 21 21 21 21 22 22 22 22 22 22 22 21 21 21 21 20 20 21 21 21 22 22 22 22 22 22 22 21 21 21 21 20 20 20 20 21 22 22 22 22 22 22 22 22 21 21 21 21 21 21 20 21 21 22 0 0 0 0 0 0 0 0 0 0 0 
0 0 0 0 0 0 0 0 0 0 0 0 0 22 21 21 21 21 21 21 21 21 21 22 0 0 0 0 0 22 21 21 21 21 21 21 21 21 21 22 0 0 0 0 0 22 25 21 21 21 21 21 21 21 21 22 0 0 0 0 0 22 25 21 21 21 21 20 20 21 21 22 0 0 0 0 0 0 22 21 21 21 21 21 21 20 21 21 22 0 0 0 0 0 0 0 0 0 0 0 
0 0 0 0 0 0 0 0 0 0 0 0 0 22 21 21 21 21 21 21 21 21 25 22 0 0 0 0 0 22 21 21 21 21 21 21 21 21 25 22 0 0 0 0 0 22 25 25 21 21 21 21 21 21 21 22 0 0 0 0 0 22 25 21 21 21 21 21 21 25 25 22 0 0 0 0 0 0 22 21 21 21 21 21 21 21 21 25 22 0 0 0 0 0 0 0 0 0 0 0 
0 0 0 0 0 0 0 0 0 0 0 0 0 22 21 21 21 21 21 21 21 25 25 22 0 0 0 0 0 22 24 21 21 21 21 21 21 25 25 22 0 0 0 0 0 22 25 25 21 21 21 21 21 21 21 22 0 0 0 0 0 22 21 21 21 21 21 21 25 25 25 22 0 0 0 0 0 0 22 21 21 21 21 21 21 21 25 25 22 0 0 0 0 0 0 0 0 0 0 0 
0 0 0 0 0 0 0 0 0 0 0 0 0 22 22 22 22 22 21 22 22 22 22 22 0 0 0 0 0 22 22 22 22 22 21 22 22 22 22 22 0 0 0 0 0 22 22 22 22 22 21 22 22 22 22 22 0 0 0 0 0 22 22 22 22 22 21 22 22 22 22 22 0 0 0 0 0 0 22 22 22 22 22 20 22 22 22 22 22 0 0 0 0 0 0 0 0 0 0 0 
0 0 0 0 0 0 0 0 0 0 0 0 0 0 0 0 0 22 21 22 0 0 0 0 0 0 0 0 0 0 0 0 0 22 21 22 0 0 0 0 0 0 0 0 0 0 0 0 0 22 21 22 0 0 0 0 0 0 0 0 0 0 0 0 0 22 21 22 0 0 0 0 0 0 0 0 0 0 0 0 0 0 22 20 22 0 0 0 0 0 0 0 0 0 0 0 0 0 0 0 
0 0 0 0 0 0 0 0 0 0 0 0 0 0 0 0 0 22 21 22 0 0 0 0 0 0 0 0 0 0 0 0 0 22 21 22 0 0 0 0 0 0 0 0 0 0 0 0 0 22 21 22 0 0 0 0 0 0 0 0 0 0 0 0 0 22 21 22 0 0 0 0 0 0 0 0 0 0 0 0 0 0 22 20 22 0 0 0 0 0 0 0 0 0 0 0 0 0 0 0 
0 0 0 0 0 0 0 0 0 0 0 0 0 0 0 0 0 22 26 22 0 0 0 0 0 0 0 0 0 0 0 0 0 22 26 22 0 0 0 0 0 0 0 0 0 0 0 0 0 22 26 22 0 0 0 0 0 0 0 0 0 0 0 0 0 22 26 22 0 0 0 0 0 0 0 0 0 0 0 0 0 0 22 26 22 0 0 0 0 0 0 0 0 0 0 0 0 0 0 0 
0 0 0 0 0 0 0 0 0 0 0 0 0 0 0 0 0 22 21 22 0 0 0 0 0 0 0 0 0 0 0 0 0 22 21 22 0 0 0 0 0 0 0 0 0 0 0 0 0 22 21 22 0 0 0 0 0 0 0 0 0 0 0 0 0 22 21 22 0 0 0 0 0 0 0 0 0 0 0 0 0 0 22 20 22 0 0 0 0 0 0 0 0 0 0 0 0 0 0 0 
0 0 0 0 0 0 0 0 0 0 0 0 0 0 0 0 0 22 21 22 0 0 0 0 0 0 0 0 0 0 0 0 0 22 21 22 0 0 0 0 0 0 0 0 0 0 0 0 0 22 21 22 0 0 0 0 0 0 0 0 0 0 0 0 0 22 21 22 0 0 0 0 0 0 0 0 0 0 0 0 0 0 22 20 22 0 0 0 0 0 0 0 0 0 0 0 0 0 0 0 
0 0 0 0 0 0 0 0 0 0 0 0 0 22 22 22 22 22 21 22 22 22 22 22 0 0 0 0 0 22 22 22 22 22 21 22 22 22 22 22 0 0 0 0 0 22 22 22 22 22 21 22 22 22 22 22 0 0 0 0 0 22 22 22 22 22 21 22 22 22 22 22 0 0 0 0 0 0 22 22 22 22 22 21 22 22 22 22 22 0 0 0 0 0 0 0 0 0 0 0 
0 0 0 0 0 0 0 0 0 0 0 0 0 22 23 23 23 21 21 21 21 23 25 22 0 0 0 0 0 22 23 20 23 20 20 20 20 23 24 22 0 0 0 0 0 22 24 23 23 21 21 21 21 21 21 22 0 0 0 0 0 22 23 23 25 21 21 21 21 23 21 22 0 0 0 0 0 0 22 25 25 23 23 21 21 21 21 25 22 0 0 0 0 0 0 0 0 0 0 0 
0 0 0 0 0 0 0 0 0 0 0 0 0 22 21 21 21 21 21 21 21 25 25 22 0 0 0 0 0 22 20 20 20 20 20 20 20 20 20 22 0 0 0 0 0 22 21 21 21 21 21 21 21 21 21 22 0 0 0 0 0 22 25 25 25 21 21 21 21 21 21 22 0 0 0 0 0 0 22 25 25 21 21 21 21 21 25 25 22 0 0 0 0 0 0 0 0 0 0 0 
0 0 0 0 0 0 0 0 0 0 0 0 0 22 21 21 21 21 21 21 21 21 21 22 0 0 0 0 0 22 20 20 20 20 20 20 20 20 20 22 0 0 0 0 0 22 21 21 21 21 21 21 21 21 21 22 0 0 0 0 0 22 21 21 21 21 21 21 21 21 21 22 0 0 0 0 0 0 22 21 21 21 21 21 21 21 21 25 22 0 0 0 0 0 0 0 0 0 0 0 
0 0 0 0 0 0 0 0 0 0 0 0 0 22 21 21 21 21 21 21 21 21 21 22 22 22 22 22 22 22 20 20 20 20 20 20 20 20 20 22 22 22 22 22 22 22 21 21 21 21 21 21 21 21 21 22 22 22 22 22 22 22 21 21 21 21 21 21 21 21 21 22 22 22 22 22 22 22 22 21 21 21 21 21 21 21 21 25 22 0 0 0 0 0 0 0 0 0 0 0 
0 0 0 0 0 0 0 0 0 0 0 0 0 22 21 21 21 21 21 21 21 21 21 20 20 20 20 20 20 20 20 20 20 20 20 20 20 20 20 20 20 20 20 20 20 20 20 20 20 20 21 21 20 20 20 20 20 20 20 20 20 20 20 20 20 20 20 20 20 20 20 20 20 20 20 20 20 20 20 20 20 20 20 21 20 20 20 20 22 0 0 0 0 0 0 0 0 0 0 0 
0 0 0 0 0 0 0 0 0 0 0 0 0 22 21 21 21 21 21 21 21 21 21 22 22 22 22 22 22 22 20 20 20 20 20 20 20 20 20 22 22 22 22 22 22 22 21 21 21 21 21 21 21 21 21 22 22 22 22 22 22 22 21 21 21 21 21 21 21 21 21 22 22 22 22 22 22 22 22 21 21 21 21 21 21 21 21 21 22 0 0 0 0 0 0 0 0 0 0 0 
0 0 0 0 0 0 0 0 0 0 0 0 0 22 21 21 21 21 21 21 21 21 21 22 0 0 0 0 0 22 20 20 20 20 20 20 20 20 25 22 0 0 0 0 0 22 21 21 21 21 21 21 21 21 21 22 0 0 0 0 0 22 21 21 21 21 21 21 21 21 21 22 0 0 0 0 0 0 22 21 21 21 21 21 21 21 21 21 22 0 0 0 0 0 0 0 0 0 0 0 
0 0 0 0 0 0 0 0 0 0 0 0 0 22 21 21 21 21 21 21 21 21 25 22 0 0 0 0 0 22 25 20 20 20 20 20 20 25 25 22 0 0 0 0 0 22 25 21 21 21 21 21 21 21 21 22 0 0 0 0 0 22 21 21 21 21 21 21 21 21 21 22 0 0 0 0 0 0 22 21 21 21 21 21 21 21 21 21 22 0 0 0 0 0 0 0 0 0 0 0 
0 0 0 0 0 0 0 0 0 0 0 0 0 22 24 21 21 21 21 21 21 25 25 22 0 0 0 0 0 22 25 20 20 20 20 20 25 25 25 22 0 0 0 0 0 22 25 25 21 21 21 21 21 21 21 22 0 0 0 0 0 22 21 21 21 21 21 21 21 21 21 22 0 0 0 0 0 0 22 21 21 21 21 21 21 21 21 21 22 0 0 0 0 0 0 0 0 0 0 0 
0 0 0 0 0 0 0 0 0 0 0 0 0 22 22 22 22 22 21 22 22 22 22 22 0 0 0 0 0 22 22 22 22 22 21 22 22 22 22 22 0 0 0 0 0 22 22 22 22 22 21 22 22 22 22 22 0 0 0 0 0 22 22 22 22 22 21 22 22 22 22 22 0 0 0 0 0 0 22 22 22 22 22 21 22 22 22 22 22 0 0 0 0 0 0 0 0 0 0 0 
0 0 0 0 0 0 0 0 0 0 0 0 0 0 0 0 0 22 21 22 0 0 0 0 0 0 0 0 0 0 0 0 0 22 21 22 0 0 0 0 0 0 0 0 0 0 0 0 0 22 21 22 0 0 0 0 0 0 0 0 0 0 0 0 0 22 21 22 0 0 0 0 0 0 0 0 0 0 0 0 0 0 22 21 22 0 0 0 0 0 0 0 0 0 0 0 0 0 0 0 
0 0 0 0 0 0 0 0 0 0 0 0 0 0 0 0 0 22 21 22 0 0 0 0 0 0 0 0 0 0 0 0 0 22 21 22 0 0 0 0 0 0 0 0 0 0 0 0 0 22 21 22 0 0 0 0 0 0 0 0 0 0 0 0 0 22 21 22 0 0 0 0 0 0 0 0 0 0 0 0 0 0 22 21 22 0 0 0 0 0 0 0 0 0 0 0 0 0 0 0 
0 0 0 0 0 0 0 0 0 0 0 0 0 0 0 0 0 22 26 27 0 0 0 0 0 0 0 0 0 0 0 0 0 22 26 22 0 0 0 0 0 0 0 0 0 0 0 0 0 22 26 22 0 0 0 0 0 0 0 0 0 0 0 0 0 22 26 22 0 0 0 0 0 0 0 0 0 0 0 0 0 0 22 26 22 0 0 0 0 0 0 0 0 0 0 0 0 0 0 0 
0 0 0 0 0 0 0 0 0 0 0 0 0 0 0 0 0 27 29 27 0 0 0 0 0 0 0 0 0 0 0 0 0 22 21 22 0 0 0 0 0 0 0 0 0 0 0 0 0 22 21 22 0 0 0 0 0 0 0 0 0 0 0 0 0 22 21 22 0 0 0 0 0 0 0 0 0 0 0 0 0 0 22 21 22 0 0 0 0 0 0 0 0 0 0 0 0 0 0 0 
0 0 0 0 0 0 0 0 0 0 0 0 0 0 0 0 0 27 29 27 0 0 0 0 0 0 0 0 0 0 0 0 0 22 21 22 0 0 0 0 0 0 0 0 0 0 0 0 0 22 21 22 0 0 0 0 0 0 0 0 0 0 0 0 0 22 21 22 0 0 0 0 0 0 0 0 0 0 0 0 0 0 22 21 22 0 0 0 0 0 0 0 0 0 0 0 0 0 0 0 
0 0 0 0 0 0 0 0 0 0 0 0 0 27 27 27 27 27 29 27 27 27 27 27 0 0 0 0 0 22 22 22 22 22 21 22 22 22 22 22 0 0 0 0 0 22 22 22 22 22 21 22 22 22 22 22 0 0 0 0 0 22 22 22 22 22 21 22 22 22 22 22 0 0 0 0 0 0 22 22 22 22 22 21 22 22 22 22 22 0 0 0 0 0 0 0 0 0 0 0 
0 0 0 0 0 0 0 0 0 0 0 0 0 27 24 28 28 28 28 28 28 28 24 27 0 0 0 0 0 22 21 23 21 21 21 21 21 23 23 22 0 0 0 0 0 22 21 23 23 21 21 21 23 21 21 22 0 0 0 0 0 22 21 23 21 21 21 21 21 21 23 22 0 0 0 0 0 0 22 21 23 21 21 21 21 21 23 21 22 0 0 0 0 0 0 0 0 0 0 0 
0 0 0 0 0 0 0 0 0 0 0 0 0 27 28 28 28 29 29 29 28 28 28 27 0 0 0 0 0 22 21 21 21 21 21 21 21 21 21 22 0 0 0 0 0 22 21 21 21 21 21 21 21 21 21 22 0 0 0 0 0 22 21 21 21 21 21 21 21 21 21 22 0 0 0 0 0 0 22 21 21 21 21 21 21 21 21 21 22 0 0 0 0 0 0 0 0 0 0 0 
0 0 0 0 0 0 0 0 0 0 0 0 0 27 28 28 28 28 28 29 29 28 28 27 0 0 0 0 0 22 21 21 21 21 21 21 21 21 21 22 0 0 0 0 0 22 21 21 21 21 21 21 21 21 21 22 0 0 0 0 0 22 21 21 21 21 21 21 21 21 21 22 0 0 0 0 0 0 22 21 21 21 21 21 21 21 21 21 22 0 0 0 0 0 0 0 0 0 0 0 
0 0 0 0 0 0 0 0 0 0 0 0 0 27 28 11 17 14 28 28 28 28 28 27 27 27 27 22 22 22 21 21 21 21 21 21 21 21 21 21 22 22 22 22 22 22 21 21 21 21 21 21 21 21 21 22 22 22 22 22 22 22 21 21 21 21 21 21 21 21 21 22 22 22 22 22 22 22 22 21 21 21 21 21 21 21 21 21 22 0 0 0 0 0 0 0 0 0 0 0 
0 0 0 0 0 0 0 0 0 0 0 0 0 27 28 15 19 18 28 28 28 28 28 29 29 21 21 21 21 21 21 21 21 21 21 21 21 21 21 21 21 21 21 21 21 21 21 21 21 21 21 21 21 21 21 21 21 21 21 21 21 21 21 21 21 21 21 21 21 21 21 21 21 21 21 21 21 21 21 21 21 21 21 21 21 21 21 21 22 0 0 0 0 0 0 0 0 0 0 0 
0 0 0 0 0 0 0 0 0 0 0 0 0 27 28 12 16 13 28 28 29 28 28 27 27 22 22 22 22 22 21 21 21 21 21 21 21 21 21 22 22 22 22 22 22 22 21 21 21 21 21 21 21 21 21 22 22 22 22 22 22 22 21 21 21 21 21 21 21 21 21 22 22 22 22 22 22 22 22 21 21 21 21 21 21 21 21 21 22 0 0 0 0 0 0 0 0 0 0 0 
0 0 0 0 0 0 0 0 0 0 0 0 0 27 28 28 29 29 28 29 29 29 28 27 0 0 0 0 0 22 21 21 21 21 21 21 21 21 25 22 0 0 0 0 0 22 25 21 21 21 21 21 21 21 21 22 0 0 0 0 0 22 21 21 21 21 21 21 21 21 25 22 0 0 0 0 0 0 22 21 21 21 21 21 21 21 21 21 22 0 0 0 0 0 0 0 0 0 0 0 
0 0 0 0 0 0 0 0 0 0 0 0 0 27 28 28 29 29 28 29 29 29 28 27 0 0 0 0 0 22 21 21 21 21 21 21 21 25 25 22 0 0 0 0 0 22 25 25 21 21 21 21 21 21 21 22 0 0 0 0 0 22 21 21 21 21 21 21 21 21 25 22 0 0 0 0 0 0 22 21 21 21 21 21 21 21 21 25 22 0 0 0 0 0 0 0 0 0 0 0 
0 0 0 0 0 0 0 0 0 0 0 0 0 27 28 28 28 28 28 28 28 28 28 27 0 0 0 0 0 22 21 21 21 21 21 21 25 25 25 22 0 0 0 0 0 22 25 25 25 21 21 21 21 21 21 22 0 0 0 0 0 22 21 21 21 21 21 21 21 25 25 22 0 0 0 0 0 0 22 21 21 21 21 21 21 21 25 25 22 0 0 0 0 0 0 0 0 0 0 0 
0 0 0 0 0 0 0 0 0 0 0 0 0 27 27 27 27 27 29 27 27 27 27 27 0 0 0 0 0 22 22 22 22 22 21 22 22 22 22 22 0 0 0 0 0 22 22 22 22 22 21 22 22 22 22 22 0 0 0 0 0 22 22 22 22 22 21 22 22 22 22 22 0 0 0 0 0 0 22 22 22 22 22 21 22 22 22 22 22 0 0 0 0 0 0 0 0 0 0 0 
0 0 0 0 0 0 0 0 0 0 0 0 0 0 0 0 0 27 29 27 0 0 0 0 0 0 0 0 0 0 0 0 0 22 21 22 0 0 0 0 0 0 0 0 0 0 0 0 0 22 21 22 0 0 0 0 0 0 0 0 0 0 0 0 0 22 21 22 0 0 0 0 0 0 0 0 0 0 0 0 0 0 22 21 22 0 0 0 0 0 0 0 0 0 0 0 0 0 0 0 
0 0 0 0 0 0 0 0 0 0 0 0 0 0 0 0 0 27 21 27 0 0 0 0 0 0 0 0 0 0 0 0 0 22 21 22 0 0 0 0 0 0 0 0 0 0 0 0 0 22 20 22 0 0 0 0 0 0 0 0 0 0 0 0 0 22 21 22 0 0 0 0 0 0 0 0 0 0 0 0 0 0 22 21 22 0 0 0 0 0 0 0 0 0 0 0 0 0 0 0 
0 0 0 0 0 0 0 0 0 0 0 0 0 0 0 0 0 22 26 27 0 0 0 0 0 0 0 0 0 0 0 0 0 22 26 22 0 0 0 0 0 0 0 0 0 0 0 0 0 22 26 22 0 0 0 0 0 0 0 0 0 0 0 0 0 22 26 22 0 0 0 0 0 0 0 0 0 0 0 0 0 0 22 26 22 0 0 0 0 0 0 0 0 0 0 0 0 0 0 0 
0 0 0 0 0 0 0 0 0 0 0 0 0 0 0 0 0 22 28 22 0 0 0 0 0 0 0 0 0 0 0 0 0 22 21 22 0 0 0 0 0 0 0 0 0 0 0 0 0 22 21 22 0 0 0 0 0 0 0 0 0 0 0 0 0 22 21 22 0 0 0 0 0 0 0 0 0 0 0 0 0 0 22 21 22 0 0 0 0 0 0 0 0 0 0 0 0 0 0 0 
0 0 0 0 0 0 0 0 0 0 0 0 0 0 0 0 0 22 21 22 0 0 0 0 0 0 0 0 0 0 0 0 0 22 21 22 0 0 0 0 0 0 0 0 0 0 0 0 0 22 21 22 0 0 0 0 0 0 0 0 0 0 0 0 0 22 21 22 0 0 0 0 0 0 0 0 0 0 0 0 0 0 22 21 22 0 0 0 0 0 0 0 0 0 0 0 0 0 0 0 
0 0 0 0 0 0 0 0 0 0 0 0 0 22 22 22 22 22 21 22 22 22 22 22 0 0 0 0 0 22 22 22 22 22 21 22 22 22 22 22 0 0 0 0 0 22 22 22 22 22 21 22 22 22 22 22 0 0 0 0 0 22 22 22 22 22 21 22 22 22 22 22 0 0 0 0 0 0 22 22 22 22 22 21 22 22 22 22 22 0 0 0 0 0 0 0 0 0 0 0 
0 0 0 0 0 0 0 0 0 0 0 0 0 22 24 21 23 21 21 21 23 21 21 22 0 0 0 0 0 22 23 21 21 21 21 21 21 23 25 22 0 0 0 0 0 22 25 25 23 21 21 21 21 21 23 22 0 0 0 0 0 22 23 21 21 21 21 21 23 21 21 22 0 0 0 0 0 0 22 21 21 23 21 21 21 21 23 21 22 0 0 0 0 0 0 0 0 0 0 0 
0 0 0 0 0 0 0 0 0 0 0 0 0 22 21 20 21 21 21 21 21 20 21 22 0 0 0 0 0 22 21 20 20 20 20 20 20 25 25 22 0 0 0 0 0 22 25 25 20 20 20 20 20 20 21 22 0 0 0 0 0 22 21 21 21 21 20 21 21 21 21 22 0 0 0 0 0 0 22 21 20 20 20 20 20 20 20 21 22 0 0 0 0 0 0 0 0 0 0 0 
0 0 0 0 0 0 0 0 0 0 0 0 0 22 21 20 21 21 21 21 21 20 21 22 0 0 0 0 0 22 21 20 21 21 21 21 21 21 25 22 0 0 0 0 0 22 21 20 21 21 21 21 21 21 21 22 0 0 0 0 0 22 21 21 21 20 21 20 21 21 21 22 0 0 0 0 0 0 22 21 20 21 21 21 21 21 21 21 22 0 0 0 0 0 0 0 0 0 0 0 
0 0 0 0 0 0 0 0 0 0 0 0 0 22 25 21 20 21 21 21 20 21 21 22 22 22 22 22 22 22 21 20 21 21 21 21 21 21 21 22 22 22 22 22 22 22 21 20 21 21 21 21 21 21 21 22 22 22 22 22 22 22 21 21 20 21 21 21 20 21 21 22 22 22 22 22 22 22 22 21 20 21 21 21 21 21 21 21 22 0 0 0 0 0 0 0 0 0 0 0 
0 0 0 0 0 0 0 0 0 0 0 0 0 22 25 21 20 21 21 21 20 21 21 20 20 20 20 20 20 21 21 20 20 20 20 20 21 21 21 21 21 21 21 21 21 21 21 20 21 21 20 20 20 20 21 21 21 20 20 20 21 21 21 21 20 20 20 20 20 21 21 21 21 23 21 21 21 21 21 21 20 20 20 20 20 20 21 21 22 0 0 0 0 0 0 0 0 0 0 0 
0 0 0 0 0 0 0 0 0 0 0 0 0 22 21 21 21 20 21 20 21 21 21 22 22 22 22 22 22 22 21 20 21 21 21 21 21 21 21 22 22 22 22 22 22 22 21 20 21 21 21 21 21 20 21 22 22 22 22 22 22 22 21 21 20 21 21 21 21 20 21 22 22 22 22 22 22 22 22 21 21 21 21 21 21 20 21 21 22 0 0 0 0 0 0 0 0 0 0 0 
0 0 0 0 0 0 0 0 0 0 0 0 0 22 21 21 21 20 21 20 21 21 21 22 0 0 0 0 0 22 24 20 21 21 21 21 21 21 21 22 0 0 0 0 0 22 21 20 21 21 21 21 21 20 21 22 0 0 0 0 0 22 25 20 21 21 21 21 21 20 21 22 0 0 0 0 0 0 22 25 21 21 21 21 21 20 24 21 22 0 0 0 0 0 0 0 0 0 0 0 
0 0 0 0 0 0 0 0 0 0 0 0 0 22 21 21 21 21 20 21 21 21 25 22 0 0 0 0 0 22 25 20 20 20 20 20 20 21 21 22 0 0 0 0 0 22 21 20 20 20 20 20 20 20 21 22 0 0 0 0 0 22 25 25 25 21 21 21 21 20 21 22 0 0 0 0 0 0 22 25 25 25 20 20 20 20 21 21 22 0 0 0 0 0 0 0 0 0 0 0 
0 0 0 0 0 0 0 0 0 0 0 0 0 22 21 21 21 21 21 25 21 21 25 22 0 0 0 0 0 22 25 25 25 25 21 21 21 21 21 22 0 0 0 0 0 22 21 21 21 21 21 20 21 21 24 22 0 0 0 0 0 22 25 25 25 21 21 21 21 21 21 22 0 0 0 0 0 0 22 25 25 25 25 25 21 21 21 21 22 0 0 0 0 0 0 0 0 0 0 0 
0 0 0 0 0 0 0 0 0 0 0 0 0 22 22 22 22 22 22 22 22 22 22 22 0 0 0 0 0 22 22 22 22 22 22 22 22 22 22 22 0 0 0 0 0 22 22 22 22 22 21 22 22 22 22 22 0 0 0 0 0 22 22 22 22 22 22 22 22 22 22 22 0 0 0 0 0 0 22 22 22 22 22 22 22 22 22 22 22 0 0 0 0 0 0 0 0 0 0 0 
0 0 0 0 0 0 0 0 0 0 0 0 0 0 0 0 0 0 0 0 0 0 0 0 0 0 0 0 0 0 0 0 0 0 0 0 0 0 0 0 0 0 0 0 0 0 0 0 0 22 21 22 0 0 0 0 0 0 0 0 0 0 0 0 0 0 0 0 0 0 0 0 0 0 0 0 0 0 0 0 0 0 0 0 0 0 0 0 0 0 0 0 0 0 0 0 0 0 0 0 
0 0 0 0 0 0 0 0 0 0 0 0 0 0 0 0 0 0 0 0 0 0 0 0 0 0 0 0 0 0 0 0 0 0 0 0 0 0 0 0 0 0 0 0 0 0 0 22 22 22 21 22 22 22 0 0 0 0 0 0 0 0 0 0 0 0 0 0 0 0 0 0 0 0 0 0 0 0 0 0 0 0 0 0 0 0 0 0 0 0 0 0 0 0 0 0 0 0 0 0 
0 0 0 0 0 0 0 0 0 0 0 0 0 0 0 0 0 0 0 0 0 0 0 0 0 0 0 0 0 0 0 0 0 0 0 0 0 0 0 0 0 0 0 0 0 0 0 22 23 21 21 21 23 22 0 0 0 0 0 0 0 0 0 0 0 0 0 0 0 0 0 0 0 0 0 0 0 0 0 0 0 0 0 0 0 0 0 0 0 0 0 0 0 0 0 0 0 0 0 0 
0 0 0 0 0 0 0 0 0 0 0 0 0 0 0 0 0 0 0 0 0 0 0 0 0 0 0 0 0 0 0 0 0 0 0 0 0 0 0 0 0 0 0 0 0 0 0 22 20 20 20 20 20 22 0 0 0 0 0 0 0 0 0 0 0 0 0 0 0 0 0 0 0 0 0 0 0 0 0 0 0 0 0 0 0 0 0 0 0 0 0 0 0 0 0 0 0 0 0 0 
0 0 0 0 0 0 0 0 0 0 0 0 0 0 0 0 0 0 0 0 0 0 0 0 0 0 0 0 0 0 0 0 0 0 0 0 0 0 0 0 0 0 0 0 0 0 0 22 20 21 20 20 20 22 0 0 0 0 0 0 0 0 0 0 0 0 0 0 0 0 0 0 0 0 0 0 0 0 0 0 0 0 0 0 0 0 0 0 0 0 0 0 0 0 0 0 0 0 0 0 
0 0 0 0 0 0 0 0 0 0 0 0 0 0 0 0 0 0 0 0 0 0 0 0 0 0 0 0 0 0 0 0 0 0 0 0 0 0 0 0 0 0 0 0 0 0 0 22 21 20 21 20 20 22 0 0 0 0 0 0 0 0 0 0 0 0 0 0 0 0 0 0 0 0 0 0 0 0 0 0 0 0 0 0 0 0 0 0 0 0 0 0 0 0 0 0 0 0 0 0 
0 0 0 0 0 0 0 0 0 0 0 0 0 0 0 0 0 0 0 0 0 0 0 0 0 0 0 0 0 0 0 0 0 0 0 0 0 0 0 0 0 0 0 0 0 0 0 22 22 22 22 22 22 22 0 0 0 0 0 0 0 0 0 0 0 0 0 0 0 0 0 0 0 0 0 0 0 0 0 0 0 0 0 0 0 0 0 0 0 0 0 0 0 0 0 0 0 0 0 0 
